1111111111111111111111111111111111110
1000000000C000000E0000000000000000001
1000000000000000000000000000000000001
1000000000000000000000000000000000001
1000000000000000000000000000000000001
1000000000000000000000000000000000001
1000000000000000000000000000000000001
1000000000000000000000000000000000001
1000000000000000000000000000000000001
1000000000000000000000000000000000001
1000000000000000000000000000000000001
1000000000000000000000000000000000001
10000C0C0C0C0000000000000000000000001
10000C0C0C0C0000000000000000000000001
10000C0C0C0C0000000000000000000000001
10000C0C0C0C0000000000000000000000001
10000C0C0P0C0000010000000000000000001
10000C0C0C0C0000000000000000000000001
10000C0C0C0C00000E0000000000000000001
1111111111111111111111111111111111111