1111111111111111111
1001000000C00000001
1001000000000000001
1001111111111000E01
10P00C0C0C0C1000001
10000C0C0C0C1000001
10000C0C0C0C1000001
1001111111111000001
10010C0C000C0001111
100111110C0C0001CC1
10000C0C0C0C0000001
1111111111111111111
